0 0 0 0 0 0 0 0 0 0 0 0 0 0 0 0 0 0 0 0
0 0 0 0 0 0 0 0 6 6 6 0 0 0 0 0 0 0 0 0
0 0 0 0 0 0 0 0 6 9 6 0 0 0 0 0 0 0 0 0
0 0 0 0 0 0 0 0 6 6 6 0 0 0 0 0 0 0 0 0
0 0 0 0 0 0 0 0 6 6 6 0 0 0 0 0 0 0 0 0
0 0 0 0 0 0 0 0 6 8 6 0 0 0 0 0 0 0 0 0
0 0 0 0 0 0 0 0 6 6 6 0 0 0 0 0 0 0 0 0
0 0 0 0 0 0 0 0 6 6 6 0 0 0 0 0 0 0 0 0
0 0 0 0 0 0 0 0 6 6 6 0 0 0 0 0 0 0 0 0
0 0 0 0 0 0 0 0 6 8 6 0 0 0 0 0 0 0 0 0
0 0 0 0 0 0 0 0 6 8 6 0 0 0 0 0 0 0 0 0
0 0 0 0 0 0 0 0 6 6 6 0 0 0 0 0 0 0 0 0
0 0 0 0 0 0 0 0 6 6 6 0 0 0 0 0 0 0 0 0
0 0 0 0 0 0 0 0 6 6 6 0 0 0 0 0 0 0 0 0
0 0 0 0 0 0 0 0 6 8 6 0 0 0 0 0 0 0 0 0
0 0 0 0 0 0 0 0 6 6 6 0 0 0 0 0 0 0 0 0
0 0 0 0 0 0 0 0 6 6 6 0 0 0 0 0 0 0 0 0
0 0 0 0 0 0 0 0 6 1 6 0 0 0 0 0 0 0 0 0
0 0 0 0 0 0 0 0 6 6 6 0 0 0 0 0 0 0 0 0
0 0 0 0 0 0 0 0 0 0 0 0 0 0 0 0 0 0 0 0
