0 0 0 0 0 0 0 0 0 0 0 0 0 0 0 0 0 0 0 0
0 9 6 6 6 6 6 6 0 6 6 8 6 6 6 6 6 6 6 0
0 6 6 6 6 6 6 6 0 6 6 6 6 6 6 6 6 6 6 0
0 6 6 6 6 6 6 6 0 6 6 0 6 6 6 6 6 6 6 0
0 0 0 0 6 0 6 6 0 6 6 0 6 6 6 6 6 8 6 0
0 2 6 6 6 0 6 6 0 6 6 0 6 6 6 6 6 6 6 0
0 6 6 6 6 0 6 6 0 6 6 0 0 0 0 2 0 6 6 0
0 8 8 6 0 0 6 6 0 6 6 6 6 6 6 6 0 6 6 0
0 8 8 6 0 6 6 6 0 8 6 6 6 6 6 6 0 6 6 0
0 0 0 0 0 6 6 6 0 0 0 0 0 0 6 6 0 6 6 0
0 6 6 6 6 6 6 6 6 6 6 6 6 6 6 6 6 6 6 0
0 6 6 6 6 6 6 6 6 6 6 6 6 6 6 6 6 6 6 0
0 6 6 6 6 6 6 6 6 6 6 6 6 6 6 6 0 6 6 0
0 6 6 6 6 6 6 6 0 0 0 6 6 6 6 6 0 6 6 0
0 6 6 0 0 0 6 6 0 6 0 6 6 6 6 8 0 6 6 0
0 6 6 0 8 0 6 6 0 6 0 6 6 6 0 0 0 6 6 0
0 6 6 0 2 0 6 6 0 6 0 6 6 6 0 6 6 6 6 0
0 6 0 0 6 0 0 0 0 6 0 6 6 6 0 6 6 6 6 0
0 6 6 6 6 6 6 6 6 6 0 6 6 6 0 6 1 6 6 0
0 0 0 0 0 0 0 0 0 0 0 0 0 0 0 0 0 0 0 0
