6 6 6 6 6 6 6 6 6 6 6 6 6 6 6 6 6 6 6 6
6 6 6 6 6 6 6 6 6 6 6 6 6 6 6 6 6 6 6 6
6 6 6 6 6 6 6 6 6 6 6 6 6 6 6 6 6 6 6 6
6 6 6 6 6 6 6 6 6 6 6 6 6 6 6 6 6 6 6 6
6 6 6 6 6 6 6 6 6 6 6 6 6 6 6 6 6 6 6 6
0 0 0 0 0 0 0 0 6 6 6 0 0 0 0 0 0 0 0 0
0 6 6 6 6 6 6 0 6 6 6 0 6 6 6 6 6 6 6 0
0 1 8 8 8 8 6 0 6 6 6 0 6 8 8 8 8 8 9 0
0 6 6 6 6 8 6 0 6 6 6 0 6 8 6 6 6 6 6 0
0 0 0 0 6 8 6 0 0 0 0 0 6 8 6 0 0 0 0 0
6 6 6 0 6 8 6 6 6 6 6 6 6 8 6 0 6 6 6 6
6 6 6 0 6 8 8 8 8 8 8 8 8 8 6 0 6 6 6 6
6 6 6 0 6 6 6 6 6 6 6 6 6 6 6 0 6 6 6 6
6 6 6 0 0 0 0 0 0 0 0 0 0 0 0 0 6 6 6 6
6 6 6 6 6 6 6 6 6 6 6 6 6 6 6 6 6 6 6 6
6 6 6 6 6 6 6 6 6 6 6 6 6 6 6 6 6 6 6 6
6 6 6 6 6 6 6 6 6 6 6 6 6 6 6 6 6 6 6 6
6 6 6 6 6 6 6 6 6 6 6 6 6 6 6 6 6 6 6 6
6 6 6 6 6 6 6 6 6 6 6 6 6 6 6 6 6 6 6 6
6 6 6 6 6 6 6 6 6 6 6 6 6 6 6 6 6 6 6 6
